//MAP CONVERTED BY dmm2tgm.py THIS HEADER COMMENT PREVENTS RECONVERSION, DO NOT REMOVE
"a" = (
/turf/template_noop,
/area/template_noop)
"b" = (
/obj/effect/baseturf_helper/asteroid/snow_naga,
/turf/simulated/mineral,
/area/ruin/unpowered)
"w" = (
/turf/simulated/mineral,
/area/ruin/unpowered)

(1,1,1) = {"
a
a
a
a
a
a
a
a
a
a
a
a
a
a
a
a
a
a
a
a
"}
(2,1,1) = {"
a
a
a
a
a
a
a
a
a
a
a
a
a
a
a
a
a
a
a
a
"}
(3,1,1) = {"
a
a
a
a
a
a
a
a
a
a
a
a
a
a
a
a
a
a
a
a
"}
(4,1,1) = {"
a
a
a
a
a
a
a
a
a
a
a
a
w
w
w
a
a
a
a
a
"}
(5,1,1) = {"
a
a
a
w
w
a
a
a
a
a
a
w
w
w
w
a
a
a
b
a
"}
(6,1,1) = {"
a
a
a
w
b
a
a
a
a
w
w
w
w
w
w
a
a
a
a
a
"}
(7,1,1) = {"
a
a
a
a
w
a
a
a
a
w
w
w
w
a
a
a
a
a
a
a
"}
(8,1,1) = {"
a
a
a
a
a
a
a
a
w
b
w
w
w
a
a
a
a
a
a
a
"}
(9,1,1) = {"
a
a
a
a
a
a
a
a
a
w
w
a
a
a
a
a
a
a
a
a
"}
(10,1,1) = {"
a
a
a
a
a
w
a
a
a
a
a
a
a
a
a
a
a
a
a
a
"}
(11,1,1) = {"
a
a
a
a
a
w
w
w
a
a
a
a
a
a
a
a
a
a
a
a
"}
(12,1,1) = {"
a
a
a
a
a
b
w
a
a
a
a
w
w
a
a
a
a
b
w
a
"}
(13,1,1) = {"
a
a
a
a
a
w
a
a
a
a
a
w
w
w
a
a
a
w
w
a
"}
(14,1,1) = {"
a
a
a
a
a
a
a
a
a
a
a
b
w
w
a
a
a
a
a
a
"}
(15,1,1) = {"
a
a
a
a
a
a
a
a
a
w
w
w
w
a
a
a
a
a
a
a
"}
(16,1,1) = {"
a
a
a
a
a
a
a
a
a
w
w
w
a
a
a
a
a
a
a
a
"}
(17,1,1) = {"
a
a
a
a
a
a
a
a
a
w
w
w
a
a
a
a
a
a
a
a
"}
(18,1,1) = {"
a
a
b
a
a
a
a
a
a
a
a
a
a
a
a
a
a
a
a
a
"}
(19,1,1) = {"
a
a
a
a
a
a
a
a
a
a
a
a
a
a
a
a
a
a
a
a
"}
(20,1,1) = {"
a
a
a
a
a
a
a
a
a
a
a
a
a
a
a
a
a
a
a
a
"}
