//MAP CONVERTED BY dmm2tgm.py THIS HEADER COMMENT PREVENTS RECONVERSION, DO NOT REMOVE
"a" = (
/turf/template_noop,
/area/template_noop)
"c" = (
/turf/simulated/floor/plasteel/airless,
/area/snowland/surface)
"d" = (
/turf/simulated/wall/r_wall,
/area/snowland/surface)
"e" = (
/obj/item/stack/cable_coil/cut,
/turf/simulated/floor/plating/asteroid/snow/naga,
/area/template_noop)
"h" = (
/obj/structure/girder,
/turf/simulated/floor/plating/asteroid/snow/naga,
/area/template_noop)
"j" = (
/obj/structure/grille/broken,
/turf/simulated/floor/plating/asteroid/snow/naga,
/area/snowland/surface)
"k" = (
/obj/effect/landmark/burnturf,
/obj/effect/baseturf_helper/asteroid/snow_naga,
/turf/simulated/floor,
/area/snowland/surface)
"l" = (
/obj/structure/girder,
/turf/simulated/floor/plating,
/area/snowland/surface)
"m" = (
/obj/structure/grille/broken,
/turf/template_noop,
/area/snowland/surface)
"n" = (
/obj/item/stack/cable_coil/cut,
/turf/template_noop,
/area/snowland/surface)
"o" = (
/obj/machinery/door/airlock/command{
	max_integrity = 40
	},
/turf/simulated/floor/plating/burnt,
/area/snowland/surface)
"p" = (
/mob/living/simple_animal/hostile/carp,
/turf/simulated/floor/plating/asteroid/snow/naga,
/area/template_noop)
"q" = (
/obj/structure/lattice,
/turf/simulated/floor/plating/asteroid/snow/naga,
/area/snowland/surface)
"s" = (
/obj/item/stack/rods,
/turf/simulated/floor/plating/asteroid/snow/naga,
/area/template_noop)
"t" = (
/obj/structure/door_assembly/door_assembly_com,
/turf/simulated/floor/plating/asteroid/snow/naga,
/area/template_noop)
"u" = (
/obj/item/clothing/head/bio_hood/virology,
/turf/simulated/floor/plating/asteroid/snow/naga,
/area/snowland/surface)
"w" = (
/obj/structure/lattice,
/turf/template_noop,
/area/snowland/surface)
"x" = (
/turf/template_noop,
/area/snowland/surface)
"y" = (
/obj/structure/lattice,
/obj/structure/door_assembly/door_assembly_vault{
	anchored = 1
	},
/turf/simulated/floor/plating,
/area/snowland/surface)
"z" = (
/obj/item/stack/rods,
/turf/template_noop,
/area/snowland/surface)
"A" = (
/obj/structure/closet/crate,
/obj/item/reagent_containers/glass/beaker/bluespace,
/turf/simulated/floor/plasteel/airless,
/area/snowland/surface)
"B" = (
/obj/item/shard{
	icon_state = "small"
	},
/turf/simulated/floor/plating/asteroid/snow/naga,
/area/snowland/surface)
"C" = (
/obj/item/stack/sheet/metal,
/turf/simulated/floor/plating/asteroid/snow/naga,
/area/template_noop)
"D" = (
/obj/effect/landmark/burnturf,
/turf/simulated/floor/plating/asteroid/snow/naga,
/area/snowland/surface)
"E" = (
/obj/item/reagent_containers/glass/beaker/large,
/turf/simulated/floor/plating/asteroid/snow/naga,
/area/template_noop)
"F" = (
/obj/effect/landmark/burnturf,
/turf/simulated/floor,
/area/snowland/surface)
"G" = (
/obj/structure/safe,
/obj/item/stack/sheet/mineral/bananium{
	amount = 5
	},
/obj/item/stack/ore/bluespace_crystal/refined{
	amount = 3
	},
/obj/item/dnainjector/comic,
/turf/simulated/floor/plasteel/airless,
/area/snowland/surface)
"H" = (
/obj/structure/table,
/obj/item/shard{
	icon_state = "medium"
	},
/turf/simulated/floor/plasteel/airless,
/area/snowland/surface)
"I" = (
/turf/simulated/floor/plating/asteroid/snow/naga,
/area/template_noop)
"J" = (
/mob/living/simple_animal/hostile/carp,
/turf/simulated/floor/plating/asteroid/snow/naga,
/area/snowland/surface)
"L" = (
/obj/item/shard,
/turf/simulated/floor/plating/asteroid/snow/naga,
/area/snowland/surface)
"M" = (
/turf/simulated/floor,
/area/snowland/surface)
"N" = (
/obj/item/clothing/suit/bio_suit/virology,
/turf/simulated/floor/plating/asteroid/snow/naga,
/area/snowland/surface)
"O" = (
/obj/item/shard{
	icon_state = "small"
	},
/turf/simulated/floor/plating/asteroid/snow/naga,
/area/template_noop)
"P" = (
/obj/item/reagent_containers/spray/cleaner,
/turf/simulated/floor/plating/asteroid/snow/naga,
/area/snowland/surface)
"R" = (
/obj/item/stack/sheet/metal,
/turf/template_noop,
/area/snowland/surface)
"S" = (
/obj/item/reagent_containers/spray/cleaner,
/turf/simulated/floor/plating/asteroid/snow/naga,
/area/template_noop)
"T" = (
/turf/simulated/wall,
/area/snowland/surface)
"U" = (
/obj/effect/landmark/burnturf,
/turf/simulated/floor/plasteel/airless,
/area/snowland/surface)
"V" = (
/obj/structure/lattice,
/turf/simulated/floor/plating/asteroid/snow/naga,
/area/template_noop)
"W" = (
/obj/effect/landmark/burnturf,
/turf/simulated/floor/plating/burnt,
/area/snowland/surface)
"X" = (
/turf/simulated/floor/plating/asteroid/snow/naga,
/area/snowland/surface)
"Y" = (
/obj/structure/girder/reinforced,
/turf/simulated/floor/plating/damaged,
/area/snowland/surface)
"Z" = (
/obj/machinery/computer/pandemic{
	circuit = /obj/effect/decal/cleanable/shreds
	},
/turf/simulated/floor/plasteel/airless,
/area/snowland/surface)

(1,1,1) = {"
a
a
a
a
a
a
a
a
a
a
a
a
a
a
a
a
a
a
a
a
"}
(2,1,1) = {"
a
d
d
d
d
d
Y
x
S
I
I
I
I
I
I
C
I
I
I
a
"}
(3,1,1) = {"
a
d
G
A
U
F
d
z
T
T
T
T
o
T
I
p
O
I
I
a
"}
(4,1,1) = {"
a
Y
c
U
c
U
d
X
w
M
c
U
M
T
V
I
I
I
I
a
"}
(5,1,1) = {"
a
Y
M
F
k
q
d
z
m
F
M
F
M
T
I
I
I
I
I
a
"}
(6,1,1) = {"
a
d
d
y
d
d
Y
X
w
X
n
X
w
T
I
I
I
C
I
a
"}
(7,1,1) = {"
a
X
X
X
X
X
P
J
X
T
T
T
x
T
I
I
V
I
I
a
"}
(8,1,1) = {"
a
X
X
X
X
X
X
X
R
X
w
X
X
x
x
I
I
I
I
a
"}
(9,1,1) = {"
a
p
s
T
m
w
T
R
X
B
X
w
X
x
z
I
s
I
I
a
"}
(10,1,1) = {"
a
s
I
T
M
F
T
X
X
X
X
X
X
x
x
I
I
I
I
a
"}
(11,1,1) = {"
a
I
I
T
c
k
T
X
X
c
F
X
j
D
T
I
I
I
t
a
"}
(12,1,1) = {"
a
C
I
T
X
M
N
s
I
I
L
q
q
X
T
I
s
I
I
a
"}
(13,1,1) = {"
a
I
I
l
T
T
T
I
I
u
j
W
c
U
T
I
I
I
I
a
"}
(14,1,1) = {"
a
I
s
p
I
I
I
I
p
I
I
c
H
Z
T
I
I
I
I
a
"}
(15,1,1) = {"
a
V
I
I
s
V
C
I
I
s
h
T
T
T
T
I
I
I
I
a
"}
(16,1,1) = {"
a
I
I
E
I
I
V
I
O
I
V
I
I
I
I
I
C
I
I
a
"}
(17,1,1) = {"
a
I
I
C
I
e
I
I
I
I
I
e
I
V
I
I
I
I
I
a
"}
(18,1,1) = {"
a
I
I
I
I
I
I
h
I
I
C
I
I
I
I
I
I
I
I
a
"}
(19,1,1) = {"
a
I
I
I
I
I
I
I
I
I
I
I
I
I
C
I
I
I
I
a
"}
(20,1,1) = {"
a
a
a
a
a
a
a
a
a
a
a
a
a
a
a
a
a
a
a
a
"}
