//MAP CONVERTED BY dmm2tgm.py THIS HEADER COMMENT PREVENTS RECONVERSION, DO NOT REMOVE
"a" = (
/turf/template_noop,
/area/template_noop)
"b" = (
/turf/simulated/mineral/random,
/area/ruin/unpowered/no_grav/way_home)
"c" = (
/turf/simulated/floor/plating/asteroid/snow/naga,
/area/ruin/unpowered)
"d" = (
/obj/structure/signpost{
	name = "salvation"
	},
/turf/simulated/floor/plating/asteroid/snow/naga,
/area/ruin/unpowered)
"l" = (
/turf/simulated/mineral/random,
/area/ruin/unpowered)
"L" = (
/turf/simulated/floor/plating/asteroid/snow/naga,
/area/ruin/unpowered/no_grav/way_home)
"P" = (
/obj/effect/baseturf_helper/asteroid/snow_naga,
/turf/simulated/floor/plating/asteroid/snow/naga,
/area/ruin/unpowered)
"S" = (
/obj/effect/baseturf_helper/asteroid/snow_naga,
/turf/simulated/mineral/random,
/area/ruin/unpowered)

(1,1,1) = {"
a
a
a
a
a
a
a
a
a
a
a
a
a
a
a
a
a
a
a
a
a
a
a
a
a
a
a
a
a
a
"}
(2,1,1) = {"
a
a
a
a
a
a
a
a
a
a
a
a
a
a
a
a
a
a
a
a
a
a
a
a
a
a
a
a
a
a
"}
(3,1,1) = {"
a
a
a
a
a
a
a
a
a
a
a
a
a
a
a
a
a
a
a
a
a
a
a
a
l
l
a
a
a
a
"}
(4,1,1) = {"
a
a
a
a
a
a
a
a
a
a
a
a
a
a
a
a
a
a
a
a
a
a
a
a
l
S
l
a
a
a
"}
(5,1,1) = {"
a
a
a
a
a
a
a
a
a
a
a
a
a
a
a
a
a
a
a
a
a
a
a
a
a
l
a
a
a
a
"}
(6,1,1) = {"
a
a
a
a
a
a
a
a
a
a
a
a
a
a
a
a
a
a
a
a
a
a
a
a
a
a
a
a
a
a
"}
(7,1,1) = {"
a
a
a
a
a
a
a
a
a
a
a
a
l
l
a
a
a
a
a
a
a
a
a
a
a
a
a
a
a
a
"}
(8,1,1) = {"
a
a
a
a
a
a
a
a
a
a
l
l
l
l
l
l
a
a
a
a
a
a
a
a
a
a
a
a
a
a
"}
(9,1,1) = {"
a
a
a
a
a
a
a
a
a
l
l
l
l
l
l
l
a
a
a
a
a
a
a
a
a
a
a
a
a
a
"}
(10,1,1) = {"
a
a
a
a
a
a
a
l
l
l
l
l
l
l
l
a
a
a
a
a
a
a
a
a
a
a
a
a
a
a
"}
(11,1,1) = {"
a
a
a
a
b
a
b
l
l
l
l
l
l
l
c
a
a
a
a
a
a
a
a
a
a
a
a
a
a
a
"}
(12,1,1) = {"
a
a
a
a
b
b
b
l
l
l
l
l
l
b
c
c
a
a
a
a
a
a
a
a
a
a
a
a
a
a
"}
(13,1,1) = {"
a
a
a
a
b
b
b
l
l
l
l
l
l
L
c
c
a
a
a
a
a
a
a
a
a
a
a
a
a
a
"}
(14,1,1) = {"
a
a
a
b
b
b
b
l
l
l
l
l
l
L
c
P
c
c
c
a
a
a
a
a
a
a
a
a
a
a
"}
(15,1,1) = {"
a
a
b
b
b
b
b
l
l
l
l
c
c
c
c
c
c
c
c
c
c
a
a
a
a
a
l
a
a
a
"}
(16,1,1) = {"
a
a
a
b
b
b
b
l
l
l
c
c
c
a
a
c
c
d
c
c
c
c
c
c
a
l
l
a
a
a
"}
(17,1,1) = {"
a
a
a
a
b
b
b
l
l
l
l
c
a
a
a
a
c
c
c
c
c
c
l
l
l
l
a
a
a
a
"}
(18,1,1) = {"
a
a
a
a
b
b
b
l
l
l
l
a
a
a
a
a
a
c
c
c
l
l
l
l
l
l
a
a
a
a
"}
(19,1,1) = {"
a
a
a
a
b
b
a
a
l
l
l
a
a
a
a
a
a
a
c
c
c
l
l
l
l
l
a
a
a
a
"}
(20,1,1) = {"
a
a
a
a
a
a
a
a
a
l
a
a
a
a
a
a
a
a
a
c
c
c
l
l
l
l
l
a
a
a
"}
(21,1,1) = {"
a
a
a
a
a
a
a
a
a
a
a
a
a
a
a
a
a
a
a
a
a
c
l
l
l
l
l
a
a
a
"}
(22,1,1) = {"
a
a
a
a
a
a
a
a
a
a
a
a
a
a
a
a
a
a
a
a
a
a
a
l
l
l
l
a
a
a
"}
(23,1,1) = {"
a
a
a
a
a
a
a
a
a
a
a
a
a
a
a
a
a
a
a
a
a
a
a
a
l
l
a
a
a
a
"}
(24,1,1) = {"
a
a
a
a
a
a
a
a
a
a
a
a
a
a
a
a
a
a
a
a
a
a
a
a
a
l
l
a
a
a
"}
(25,1,1) = {"
a
a
a
a
a
a
a
a
a
a
a
a
a
a
a
a
a
a
a
a
a
a
a
a
a
a
a
a
a
a
"}
(26,1,1) = {"
a
a
a
a
a
a
a
a
a
a
a
a
a
a
a
a
a
a
a
a
a
a
a
a
a
a
a
a
a
a
"}
(27,1,1) = {"
a
a
a
a
a
a
a
a
a
a
a
a
a
a
a
a
a
a
a
a
a
a
a
a
a
a
a
a
a
a
"}
(28,1,1) = {"
a
a
a
a
a
a
a
a
a
a
a
a
a
a
a
a
a
a
a
a
a
a
a
a
a
a
a
a
a
a
"}
(29,1,1) = {"
a
a
a
a
a
a
a
a
a
a
a
a
a
a
a
a
a
a
a
a
a
a
a
a
a
a
a
a
a
a
"}
(30,1,1) = {"
a
a
a
a
a
a
a
a
a
a
a
a
a
a
a
a
a
a
a
a
a
a
a
a
a
a
a
a
a
a
"}
